# Library and Background barcodes 
AncSR1_REBC1	GTGTATGGTCATGTNNSNNSTGTNNSNNS
AncSR1_REBC2	GGGTTTGGTCGTGTNNSNNSTGTNNSNNS
AncSR1_REBC3	GGGTTTGGAGTTGTNNSNNSTGTNNSNNS
AncSR1_REBC4	GTGTATGGAGCTGTNNSNNSTGTNNSNNS
#
AncSR1_REBC5	GCGTTTGGTCATGCNNSNNSTGTNNSNNS
AncSR1_REBC6	GAGTATGGTCGTGCNNSNNSTGTNNSNNS
AncSR1_REBC7	GTGTCTGGAGTTGCNNSNNSTGTNNSNNS
AncSR1_REBC8	GCGTGTGGAGCTGCNNSNNSTGTNNSNNS
#
AncSR1_REBC9	GCGTCTGGTCATGTNNSNNSTGCNNSNNS
AncSR1_REBC10	GAGTGTGGTCGTGTNNSNNSTGCNNSNNS
AncSR1_REBC11	GCGTGTGGAGTTGTNNSNNSTGCNNSNNS
AncSR1_REBC12	GAGTCTGGAGCTGTNNSNNSTGCNNSNNS
#
AncSR1_REBC13	GTGTGTGGTCATGCNNSNNSTGCNNSNNS
AncSR1_REBC14	GGGTCTGGTCGTGCNNSNNSTGCNNSNNS
AncSR1_REBC15	GAGTTTGGAGTTGCNNSNNSTGCNNSNNS
AncSR1_REBC16	GGGTATGGAGCTGCNNSNNSTGCNNSNNS
#
AncSR2_REBC1	GTGTACTCACTTGTNNSNNSTGTNNSNNS
AncSR2_REBC2	GTGTGTTAACTTGTNNSNNSTGTNNSNNS
AncSR2_REBC3	GTGTCCTTACCTGTNNSNNSTGTNNSNNS
AncSR2_REBC4	GTGTTCTAACGTGTNNSNNSTGTNNSNNS
#
AncSR2_REBC5	GTGTATTGACGTGTNNSNNSTGTNNSNNS
AncSR2_REBC6	GTGTCCTGACTTGCNNSNNSTGTNNSNNS
AncSR2_REBC7	GTGTTCTCACCTGCNNSNNSTGTNNSNNS
AncSR2_REBC8	GTGTCTTAACCTGCNNSNNSTGTNNSNNS
#
AncSR2_REBC9	GTGTGCTTACATGCNNSNNSTGTNNSNNS
AncSR2_REBC10	GTGTTCTGACTTGTNNSNNSTGCNNSNNS
AncSR2_REBC11	GTGTGCTCACCTGTNNSNNSTGCNNSNNS
AncSR2_REBC12	GTGTACTTACATGTNNSNNSTGCNNSNNS
#
AncSR2_REBC13	GTGTCCTCACATGCNNSNNSTGCNNSNNS
AncSR2_REBC14	GTGTATTAACATGCNNSNNSTGCNNSNNS
AncSR2_REBC15	GTGTTCTTACGTGCNNSNNSTGCNNSNNS
AncSR2_REBC16	GTGTGTTGACGTGCNNSNNSTGCNNSNNS
