# spike-in reference sequences
AncSR1_ERE	TTATGGTGTTTGGTCTTGTGAAGGTTGTAAAGCT
AncSR2_rh_ERE	TTATGGTGTTTTAACTTGTGAAGGTTGTAAAGCT
AncSR2_SRE	TTATGGTGTTTTAACTTGTGGTTCTTGTAAAGTT
AncSR1_GGKM_ERE	TTATGGTGTTTGGTCTTGTGGTGGTTGTAAAATG
AncSR2_GGKM_SRE	TTATGGTGTTTTAACTTGTGGTGGTTGTAAAATG
SR1_REBC1cminilib	TTATGGTGTATGGTCATGTGAAGGTTGTAAAGCT
SR1_REBC2cminilib	TTATGGGGTTTGGTCGTGTGAAGGTTGTAAAGCT
SR1_REBC3cminilib	TTATGGGGTTTGGAGTTGTGAAGGTTGTAAAGCT
SR1_REBC4cminilib	TTATGGTGTATGGAGCTGTGAAGGTTGTAAAGCT
SR1_REBC5cminilib	TTATGGCGTTTGGTCATGCGAAGGTTGTAAAGCT
SR1_REBC6cminilib	TTATGGAGTATGGTCGTGCGAAGGTTGTAAAGCT
SR1_REBC7cminilib	TTATGGTGTCTGGAGTTGCGAAGGTTGTAAAGCT
SR1_REBC8cminilib	TTATGGCGTGTGGAGCTGCGAAGGTTGTAAAGCT
SR1_REBC9cminilib	TTATGGCGTCTGGTCATGTGAAGGTTGCAAAGCT
SR1_REBC10cminilib	TTATGGAGTGTGGTCGTGTGAAGGTTGCAAAGCT
SR1_REBC11cminilib	TTATGGCGTGTGGAGTTGTGAAGGTTGCAAAGCT
SR1_REBC12cminilib	TTATGGAGTCTGGAGCTGTGAAGGTTGCAAAGCT
SR1_REBC13cminilib	TTATGGTGTGTGGTCATGCGAAGGTTGCAAAGCT
SR1_REBC14cminilib	TTATGGGGTCTGGTCGTGCGAAGGTTGCAAAGCT
SR1_REBC15cminilib	TTATGGAGTTTGGAGTTGCGAAGGTTGCAAAGCT
SR1_REBC16cminilib	TTATGGGGTATGGAGCTGCGAAGGTTGCAAAGCT
SR2_REBC1cminilib	TTATGGTGTACTCACTTGTGGTTCTTGTAAAGTT
SR2_REBC2cminilib	TTATGGTGTGTTAACTTGTGGTTCTTGTAAAGTT
SR2_REBC3cminilib	TTATGGTGTCCTTACCTGTGGTTCTTGTAAAGTT
SR2_REBC4cminilib	TTATGGTGTTCTAACGTGTGGTTCTTGTAAAGTT
SR2_REBC5cminilib	TTATGGTGTATTGACGTGTGGTTCTTGTAAAGTT
SR2_REBC6cminilib	TTATGGTGTCCTGACTTGCGGTTCTTGTAAAGTT
SR2_REBC7cminilib	TTATGGTGTTCTCACCTGCGGTTCTTGTAAAGTT
SR2_REBC8cminilib	TTATGGTGTCTTAACCTGCGGTTCTTGTAAAGTT
SR2_REBC9cminilib	TTATGGTGTGCTTACATGCGGTTCTTGTAAAGTT
SR2_REBC10cminilib	TTATGGTGTTCTGACTTGTGGTTCTTGCAAAGTT
SR2_REBC11cminilib	TTATGGTGTGCTCACCTGTGGTTCTTGCAAAGTT
SR2_REBC12cminilib	TTATGGTGTACTTACATGTGGTTCTTGCAAAGTT
SR2_REBC13cminilib	TTATGGTGTCCTCACATGCGGTTCTTGCAAAGTT
SR2_REBC14cminilib	TTATGGTGTATTAACATGCGGTTCTTGCAAAGTT
SR2_REBC15cminilib	TTATGGTGTTCTTACGTGCGGTTCTTGCAAAGTT
SR2_REBC16cminilib	TTATGGTGTGTTGACGTGCGGTTCTTGCAAAGTT